 5  5  5  1  1  1  1  1  1  1  1  1  5 
 5  5  5  1  7  0  0  0  0  0  0  1  5 
 5  5  5  1  7  0  0  0  0  0  0  1  5 
 5  5  5  1  2  0  0  0  0  0  0  1  5 
 5  5  5  1  0  1  1  1  0  0  0  1  5 
 5  5  6  1  0  1  4  1  0  0  0  1  5 
 5  5  5  1  0  1  7  1  0  0  0  1  5 
 5  5  5  1  0  1  7  1  0  0  0  1  6 
 5  5  5  1  0  1  1  1  0  0  0  1  5 
 5  5  5  1  0  0  0  0  0  0  0  1  5 
 5  6  5  1  0  0  0  0  0  0  0  1  5 
 5  5  5  1  0  1  1  1  1  2  0  1  5 
 1  1  1  1  0  1  5  5  1  0  0  1  5 
 1  0  0  0  0  1  5  5  1  0  0  1  5 
 1  0  0  0  0  1  5  5  1  0  0  1  1 
 1  0  0  0  1  1  5  5  1  0  0  0  1 
 1  0  0  0  1  0  5  5  1  0  0  0  1 
 1  0  0  0  1  1  5  6  1  0  0  1  1 
 1  0  0  0  9  1  5  5  1  0  0  1  0 
 1  0  0  0  9  1  5  5  1  0  0  1  5 
 1  8  0  0  2  1  5  5  1  8  0  1  5 
 1  8  8  0  0  1  5  5  1  0  0  1  5 
 1  1  1  1  0  1  5  5  1  8  3  1  5 
 0  0  0  1 10  1  5  5  1  1  1  1  5 
