 0  0  0  0  0  0  0  1  0  0  1  0  0  0  0  0  0  0  0  0 
 0  0  0  0  0  9  0  1  0  0  1  0  0  0  0  0  0  0  0  0 
 0  0  0  0  0  5  5  1  3  0  1  5  5  0  0  0  0  0  0  0 
 0  0  0  0  5  1  1  1  0  0  1  1  1  5  9  0  0  0  0  0 
 0  0  0  0  1  1  0  0  0  0  0  0  1  1  0  0  0  0  0  0 
 0  0  7  0  1  7  0  0  0  0  0  0  8  1  0  0  0  0  0  0 
 0  0  1  2  1  0  0  0  4  4  0  0  0  1  2  1  0  0  0  0 
 0  0  1  0  1  0  0  0  4  4  0  0  0  1  0  1  0  0  0  0 
 0  0  1  0  1  0  0  0  4  4  0  0  0  1  0  1  0  0  0  0 
 0  0  1  0  0  4  0  0  0  0  0  0  4  0  0  1  0  0  0  0 
 0  0  0  5  0  0  4  0  0  0  0  4  0  0  5  0  0  0  0  0 
 0  0  0  0  5  0  0  4  0  0  1  0  0  5  0  0  0  0  0  0 
 0  0  0  0  0  5  0  0  0  0  1  0  1  9  0  0  0  0  0  0 
 0  0  0  0  9  0  5  1  1  0  1  0  1  0  0  0  0  0  0  0 
 0  0  0  0  0  0  0  5  1  0  1  0  1  0  0  0  0  0  0  0 
 0  0  0  0  0  0  0  5  1  0  1  0  1  0  0  0  0  0  0  0 
 0  0  0  0  0  0  0  6  1  0  0  0  1  0  0  0  0  0  0  0 
 0  0  0  0  0  0  0  5  1  0  1  1  1  0  0  0  0  0  0  0 
 0  0  0  0  0  0  0  5  1  0  1  0  9  0  0  0  0  0  0  0 
 0  0  0  0  0  0  0  5  1 10  1  0  0  0  0  0  0  0  0  0 
