 0  0  0  0  0  0  0  0  0  0  0  0  0  0  0 
 0  0  1  1  1  1  1  1  1  1  1  1  1  0  0 
 0  0  1  0  0  2  0  0  0  0  0  0  1  0  0 
 0  9  1  0  1  1  1  1  1  1  1  0  1  0  0 
 0  0  1  0  1  4  4  4  4  4  1  0  1  0  0 
 1  1  1  0  1  1  1  0  1  1  1  0  1  1  1 
 1  0  0  0  0  0  1  0  1  0  0  0  0  0  1 
 1  0  5  5  5  0  1  0  1  0  0  0  0  0  1 
 1  0  5  6  5  0  1  7  1  0  0  5  0  0  1 
 1  0  0  0  0  0  1  0  1  0  0  5  0  0  1 
 1  1  1  0  1  1  1  0  1  0  0  5  0  0  1 
 0  0  1  3  1  0  0  0  1  0  0  5  0  0  1 
 0  0  1  0  1  0  0  0  1  0  0  0  0  0  1 
 0  0  1  0  1  0  0  0  1  0  0  0  0  2  1 
 0  0  1  0  1  0  0  0  1  1  1 10  1  1  1 
