 5  5  5  5  1  0  1  1  1  1  1  1  1  1  1 
 1  1  1  1  1  3  1  0  0  0  0  0  0  0  1 
 1  2  0  0  0  0  1  0  0  0  0  0  2  0  1 
 1  0  0  7  0  7  1  0  0  0  0  0  0  0  1 
 1  0  0  1  1  1  1  0  0  0  1  0  0  0  1 
 1  0  0  0  0  0  0  0  0  0  1  0  0  0  1 
 1  0  0  0  0  0  0  0  0  0  1  0  0  7  1 
 1  0  0  7  0  0  0  0  0  0  1  0  0  0  1 
 1  1  1  1  1  1  1  1  1  1  1  7 10  7  1 
 0  0  0  0  0  0  0  0  0  0  0  0  0  0  0 
 0  0  0  0  0  0  0  0  0  0  0  0  0  0  0 
 0  0  0  0  0  0  0  0  0  0  0  0  0  0  0 
 0  0  0  0  0  0  0  0  0  0  0  0  0  0  0 
 0  0  0  0  0  0  0  0  0  0  0  0  0  0  0 
 0  0  0  0  0  0  0  0  0  0  0  0  0  0  0 
