 0  0  0  0  0  0  0  0  0  0  0  0  0  0  0 
 0  0  0  0  0  0  0  0  0  0  0  0  0  0  0 
 0  0  0  0  0  0  0  0  0  0  0  0  0  0  0 
 0  0  5  5  6  5  5  0  0  0  9  0  0  0  0 
 1  1  1  1  1  1  1  1  1  1  0  0  0  0  0 
 0  3  0  0  0  0  0  0  2  1  0  0  0  0  0 
 1  1  4  4  4  4  0  4  4  1  0  0  0  0  0 
 9  1  0  0  0  0  0  0  7  1  0  0  0  0  0 
 0  1  0  4  0  4  4  4  4  1  1  0  0  0  0 
 0  1  0  4  0  0  0  0  0  0 10  0  0  0  0 
 0  1  0  4  4  4  4  4  4  1  1  0  0  0  0 
 0  1  0  0  2  0  0  0  7  1  0  0  0  0  0 
 0  1  1  1  1  1  1  1  1  1  0  0  0  0  0 
 0  0  0  0  0  0  0  0  0  0  0  0  0  0  0 
 0  0  0  0  0  0  0  0  0  0  0  0  0  0  0 
