 0  0  0  0  0  0  0  0  0  0  0  0  0  0  0  0  0  0  0  0  0  0  0  0  0  0  0  0  0  0 
 0  0  0  0  0  0  0  0  0  0  0  0  0  0  0  0  0  0  0  0  0  0  0  0  0  0  0  0  0  0 
 0  0  0  0  0  0  0  0  0  0  0  0  0  0  0  0  0  0  0  0  0  0  0  0  0  0  0  0  0  0 
 0  0  0  0  0  5  1  1  1  1  0  0  0  0  0  0  0  0  0  1  1  1  1  5  0  0  0  0  0  0 
 0  0  0  0  0  5  1  0  3  1  0  0  0  0  0  0  0  0  0  1  0  0  1  5  0  0  0  0  0  0 
 0  0  0  0  0  5  1  0  0  1  0  0  0  0  0  0  0  0  0  1  0  0  1  5  0  0  0  0  0  0 
 0  0  0  0  0  5  1  0  0  1  0  0  0  0  0  0  0  0  0  1  0  0  1  5  0  0  0  0  0  0 
 0  0  0  0  0  5  1  0  0  1  9  0  0  0  0  0  0  0  8  1  0  0  1  5  0  0  0  0  0  0 
 0  0  0  0  0  5  1  0  0  1  0  4  4  0  0  0  0  0  0  1  0  0  1  1  1  0  0  0  0  0 
 0  0  0  0  1  1  1  0  0  1  0  4  4  0  0  0  0  0  0  1  0  0  0  2  1  0  0  0  0  0 
 0  0  0  0  1  0  0  0  0  1  0  0  0  0  0  0  0  0  0  1  0  0  0  0  1  0  0  0  0  0 
 0  0  0  0  1  2  0  0  0  1  0  0  0  0  0  0  0  0  0  1  0  0  1  1  1  0  0  0  0  0 
 0  0  0  0  1  1  1  0  0  1  0  0  5  5  5  5  5  0  0  1  0  0  1  5  0  0  0  0  0  0 
 0  0  0  0  0  5  1  0  0  1  0  6  5  5  5  5  5  6  0  1  0  0  1  5  0  0  0  0  0  0 
 0  0  0  0  0  5  1  0  0  1  0  0  5  5  5  5  5  0  0  1  0  0  1  5  0  0  0  0  0  0 
 0  0  0  0  0  5  1  0  0  1  0  0  0  0  0  0  0  0  0  1  0  0  1  5  0  0  0  0  0  0 
 0  0  0  0  0  5  1  0  0  1  0  7  0  0  0  0  0  0  4  1  0  0  1  5  0  0  0  0  0  0 
 0  0  0  0  0  5  1  0  0  1  1  1  1  1  1  1  1  1  1  1  0  0  1  5  0  0  0  0  0  0 
 0  0  0  0  0  5  1  0  0  0  0  0  0  0  0  0  0  0  0  0  0  0  1  5  0  0  0  0  0  0 
 0  0  0  0  0  5  1  0  0  0  0  0  0  0  0  0  0  0  0  0  0  0  1  5  0  0  0  0  0  0 
 0  0  0  0  0  5  1  1  1  1  1  1  1  1  1  1  0  0  1  1  1  1  1  5  0  0  0  0  0  0 
 0  0  0  0  0  5  5  5  5  5  5  5  5  5  5  1  0  2  1  5  5  5  5  5  0  0  0  0  0  0 
 0  0  0  0  0  0  0  0  0  0  0  0  0  0  0  1  1  1  1  0  0  0  0  0  0  0  0  0  0  0 
 0  0  0  0  0  0  0  0  0  0  0  0  0  0  0  0  0  0  0  0  0  0  0  0  0  0  0  0  0  0 
 0  0  0  0  0  0  0  0  0  0  0  0  0  0  0  0  0  0  0  0  0  0  0  0  0  0  0  0  0  0 
 0  0  0  0  0  0  0  0  0  0  0  0  0  0  0  0  0  0  0  0  0  0  0  0  0  0  0  0  0  0 
 0  0  0  0  0  0  0  0  0  0  0  0  0  0  0  0  0  0  0  0  0  0  0  0  0  0  0  0  0  0 
 0  0  0  0  0  0  0  0  0  0  0  0  0  0  0  0  0  0  0  0  0  0  0  0  0  0  0  0  0  0 
 0  0  0  0  0  0  0  0  0  0  0  0  0  0  0  0  0  0  0  0  0  0  0  0  0  0  0  0  0  0 
 0  0  0  0  0  0  0  0  0  0  0  0  0  0  0  0  0  0  0  0  0  0  0  0  0  0  0  0  0  0 
