 0  0  0  0  0  0  0  0  0  0  0  0  0  0  0  0  0  0  0  0 
 0  1  1  1  1  1  1  1  0  1  1  1  1  1  1  0  0  0  0  0  
 0  1  0  9  0  0  0  1  1  1  0  0  0  0  1  0  0  0  0  0 
 0  1  0  0  3  0  0  0  0  0  0  4  4  2  1  0  0  0  0  0 
 0  1  0  0  0  0  0  1  1  1  1  1  1  1  1  0  0  0  0  0 
 0  1  1  1  1  0  0  1  5  5  6  5  5  0  0  0  0  0  0  0 
 0  0  0  4  1  0  0  1  1  1  1  1  1  1  0  0  0  0  0  0 
 0  0  0  4  1  0  0  0  0  0  0  0  7  1  0  0  0  0  0  0 
 0  1  1  1  1  0  0  0  0  0  0  0  0  1  0  0  0  0  0  0 
 0  1  0  0  0  0  0  0  0  0  0  0  0  1  0  0  0  0  0  0 
 0  1  0  0  0  0  0  1  1  1  1  0  0  1  0  0  0  0  0  0 
 0  1  0  2  0  2  0  1  0  0  1  0  0  1  0  0  0  0  0  0 
 0  1  0  0  8  0  0  1  0  0  1  0  0  1  0  0  0  0  0  0 
 0  1  1  1  1  1  1  1  0  0  1  1  1  1  0  0  0  0  0  0 
 0  0  0  0  0  0  0  0  0  0  0  0  0  0  0  0  0  0  0  0 
 0  0  0  0  0  0  0  0  0  0  0  0  0  0  0  0  0  0  0  0 
 0  0  0  0  0  0  0  0  0  0  0  0  0  0  0  0  0  0  0  0 
 0  0  0  0  0  0  0  0  0  0  0  0  0  0  0  0  0  0  0  0 
 0  0  0  0  0  0  0  0  0  0  0  0  0  0  0  0  0  0  0  0 
 0  0  0  0  0  0  0  0  0  0  0  0  0  0  0  0  0  0  0  0 
