 0  0  0  0  5  1  0  1  5  0  0  0  0  0  0  0  0  0  0  0  0  0  0  0  0  0  0  0  0  0 
 0  0  0  0  0  1  3  1  0  0  0  0  0  0  0  0  0  0  0  0  0  0  0  0  0  0  0  0  0  0 
 0  0  0  0  5  1  0  1  5  0  0  0  0  0  0  0  0  0  0  0  0  0  0  0  0  0  0  0  0  0 
 0  0  0  0  0  1  0  1  0  0  0  0  0  0  0  0  0  0  0  0  0  0  0  0  0  0  0  0  0  0 
 0  0  0  0  0  1  0  1  0  0  0  0  0  0  0  0  0  0  0  0  0  0  0  0  0  0  0  0  0  0 
 0  0  0  1  1  1  0  1  1  1  5  0  0  0  0  0  0  0  0  0  0  0  0  0  0  0  0  0  0  0 
 0  0  0  1  0  0  0  0  0  1  5  0  0  0  0  0  0  0  0  0  0  0  0  0  0  0  0  0  0  0 
 0  0  9  1  0  4  4  4  0  1  5  0  0  0  0  0  0  0  0  0  0  0  0  0  0  0  0  0  0  0 
 0  0  0  1  0  4  4  4  0  1  6  0  0  0  0  0  0  0  0  0  0  0  0  0  0  0  0  0  0  0 
 0  0  0  1  0  4  4  4  0  1  5  0  0  0  0  0  0  0  0  0  0  0  0  0  0  0  0  0  0  0 
 0  0  0  1  0  0  0  0  0  1  5  0  0  0  0  0  0  0  0  0  0  0  0  0  0  0  0  0  0  0 
 0  0  0  1  1  1  0  1  1  1  5  0  0  0  0  0  0  0  0  0  5  5  5  5  5  5  5  5  5  5 
 0  0  0  0  5  1  0  1  0  0  0  0  0  0  0  0  0  0  0  0  5  1  1  1  1  1  1  1  1  1 
 0  0  0  0  5  1  0  1  0  0  0  0  0  0  0  0  0  0  0  0  5  1  0  0  0  0  0  0  0 10 
 0  0  0  0  5  1  0  1  9  0  0  0  0  0  0  0  0  0  0  0  5  1  0  2  1  1  1  1  1  1 
 0  0  0  0  5  1  0  1  0  0  0  0  0  0  0  0  0  0  0  0  5  1  0  0  1  5  5  5  5  5 
 0  0  1  1  1  1  2  1  1  1  1  1  0  0  0  0  0  0  1  1  1  1  0  0  1  1  1  1  0  0 
 0  0  1  0  0  0  0  0  0  0  0  1  0  0  0  0  0  0  1  0  0  0  0  0  0  0  0  1  0  0 
 0  0  1  0  0  0  0  0  0  0  0  1  5  5  6  5  5  5  1  0  0  0  0  0  0  0  0  1  0  0 
 0  0  1  0  0  1  1  1  1  0  0  1  1  1  1  1  1  1  1  0  0  0  0  0  0  0  0  1  0  0 
 0  0  1  0  0  1  5  5  1  0  0  0  0  0  0  0  0  0  0  0  0  0  4  4  0  0  0  1  0  0 
 0  0  1  0  0  1  5  5  1  0  0  0  0  0  0  2  0  0  0  0  0  0  4  4  0  0  0  1  0  0 
 0  0  1  0  0  1  1  1  1  0  0  1  1  1  1  1  1  1  1  0  0  0  0  0  0  0  0  1  0  0 
 0  0  1  0  0  0  0  0  0  0  0  1  5  5  5  5  5  5  1  0  0  0  0  0  0  0  0  1  0  0 
 0  0  1  0  0  0  0  0  0  0  0  1  0  0  0  0  0  0  1  0  0  0  0  0  0  0  0  1  0  0 
 0  0  1  1  1  1  1  1  1  1  1  1  0  0  0  0  0  0  1  1  1  1  1  1  1  1  1  1  0  0 
 0  0  9  0  0  0  0  0  0  0  0  0  0  0  0  0  0  0  0  0  0  0  0  0  0  0  0  0  0  0 
 0  0  0  0  0  0  0  0  0  0  0  0  0  0  0  0  0  0  0  0  0  0  0  0  0  0  0  0  0  0 
 0  0  0  0  0  0  0  0  0  0  0  0  0  0  0  0  0  0  0  0  0  0  0  0  0  0  0  0  0  0 
 0  0  0  0  0  0  0  0  0  0  0  0  0  0  0  0  0  0  0  0  0  0  0  0  0  0  0  0  0  0 
