 5  5  5  5  5  5  5  5  5  5  5  5  5  5  3  5  5  5  5  5  5  5  5  5  5  5  5  5  5  5 
 5  0  0  0  0  0  0  0  0  0  5  0  0  0  0  0  0  0  0  0  0  0  5  5  5  0  0  0  5  5 
 5  0  5  5  5  5  6  5  5  0  5  0  5  6  5  5  0  5  5  5  5  0  5  5  5  0  5  0  5  5 
 5  0  5  5  0  0  0  0  0  0  0  0  0  0  0  0  0  5  0  0  0  0  5  5  5  0  6  0  5  5 
 5  0  5  5  0  5  0  5  5  5  5  5  5  5  5  0  5  5  5  5  5  0  5  5  5  0  5  0  5  5 
 5  0  5  5  0  5  0  0  0  0  0  0  0  0  5  0  0  0  0  5  5  0  5  5  5  0  0  0  5  5 
 5  0  5  5  0  5  5  5  5  5  5  5  5  5  5  0  5  5  0  5  5  0  5  5  5  5  0  5  5  5 
 5  5  5  5  0  0  0  0  5  5  0  0  0  0  0  0  5  5  0  5  5  0  0  0  0  0  0  5  5  5 
 5  6  5  5  0  5  5  0  5  5  0  5  5  5  5  5  5  5  0  5  5  5  5  5  5  5  5  5  5  5 
 5  0  0  0  0  5  5  0  5  5  0  5  5  5  0  0  0  0  0  5  5  5  5  5  0  0  0  0  0  5 
 5  0  5  5  5  5  5  0  5  5  0  5  0  0  0  5  5  5  0  0  0  0  0  0  0  6  5  5  0  5 
 5  0  5  5  5  5  5  0  5  5  0  5  5  5  5  5  5  5  0  5  5  5  5  5  0  5  5  5  2  5 
 5  5  5  5  0  0  0  0  5  5  0  0  0  0  5  5  5  5  6  5  5  5  5  5  0  0  0  0  0  5 
 5  5  5  5  0  5  5  6  5  5  6  5  5  0  5  5  0  0  0  0  0  0  0  5  5  5  5  5  5  5 
 5  5  5  5  0  5  5  5  5  5  5  5  5  0  5  5  0  5  5  5  5  5  0  0  0  0  0  5  5  5 
 5  0  0  0  0  5  0  0  0  0  0  0  0  0  5  5  0  5  0  0  0  5  5  5  5  5  0  5  5  5 
 5  0  6  5  0  5  5  5  5  5  5  5  5  5  5  5  0  5  0  5  0  5  5  5  5  5  0  5  5  5 
 5  0  5  5  0  0  0  0  0  5  0  0  0  0  0  0  0  5  0  5  0  5  5  5  5  6  0  5  5  5 
 5  0  5  5  5  5  5  5  0  5  5  5  0  5  5  5  5  5  0  5  5  5  0  0  0  0  0  5  5  5 
 5  0  5  5  0  0  0  0  0  6  5  5  0  0  0  0  0  0  0  0  5  5  0  5  5  5  0  5  5  5 
 5  0  5  5  0  5  5  5  0  5  5  5  0  5  5  0  5  5  5  0  5  5  0  5  5  5  0  5  5  5 
 5  0  5  5  0  5  0  0  0  5  5  5  0  5  5  0  5  0  5  0  5  5  0  0  0  0  0  0  0  5 
 5  0  5  5  0  5  0  6  0  5  5  5  0  5  5  0  5  0  5  5  5  5  5  5  5  5  5  5  0  5 
 5  0  5  5  0  5  0  5  0  5  5  5  0  5  5  0  6  0  5  0  0  0  0  0  5  5  5  5  0  5 
 5  0  5  5  0  5  0  0  0  5  5  5  0  5  5  0  0  0  5  0  5  0  5  0  5  5  5  5  0  5 
 5  0  5  5  0  5  5  5  5  5  5  5  0  5  5  5  5  5  5  0  5  5  5  0  0  0  0  5  0  5 
 5  0  5  5  0  5  0  0  0  0  0  5  0  5  0  0  0  0  0  0  5  5  5  0  5  5  0  6  0  5 
 5  0  5  5  0  5  0  5  5  5  0  5  0  5  0  5  5  5  5  5  5  5  5  0  5  5  0  0  2  5 
 5  0  5  5  0  0  0  0  0  0  0  0  0  5  0  5  5  5  5  5  5  5  5  5  5  5  5  5  5  5 
 5  6  5  5  5  5  5  5  5  5  5  5  5  5  0  5  5  5  5  5  5  5  5  5  5  5  5  5  5  5 
