 3  1 10  2  0  0  0  0  0  0  0  0  5  5  5 
 0  1  5  5  5  5  5  1  1  1  1  0  0  0  0 
 0  1  1  1  1  1  1  1  8  8  1  0  4  0  0 
 0  0  0  0  0  0  0  0  0  0  1  0  4  0  0 
 0  1  1  1  1  1  0  4  0  0  1  0  4  0  0 
 0  0  0  0  0  0  0  0  0  0  1  0  7  0  0 
 0  0  0  0  0  0  0  0  0  0  0  0  0  0  0 
 0  1  1  1  1  1  1  1  1  1  1  0  0  0  0 
 0  1  5  5  5  6  5  5  5  5  1  0  0  0  0 
 2  1  1  1  1  1  1  1  1  1  1  5  5  5  5 
