 0  0  0  5  5  5  5  5  5  5  5  5  5  5  5  5  5  5  5  5 
 0  5  0  5  5  5  5  5  6  5  5  5  5  5  5  5  5  5  5  5 
 0  0  0  1  1  1  1  1  1  1  1  1  1  1  1  1  1  1  0  0 
 0  0  1  1  0  0  0  0  0  7  0  2  0  0  0  0  0  0 10  0 
 0  0  3  0  0  0  0  0  0  0  7  0  0  0  0  0  0  1  1  0 
 0  0  4  1  5  0  0  0  0  0  0  0  0  0  0  0  0  1  0  0 
 0  4  4  1  5  0  0  0  0  0  0  0  0  0  2  0  0  1  0  0 
 0  0  0  1  5  0  0  0  0  0  4  0  0  0  0  0  0  1  0  0 
 0  0  0  1  6  0  0  0  0  0  0  4  0  0  0  2  0  1  5  0 
 0  0  0  1  5  0  4  0  0  0  0  4  0  0  0  0  0  1  0  5 
 0  0  0  1  5  0  0  0  0  0  0  0  0  0  0  0  7  1  0  0 
 0  0  0  1  5  0  0  2  0  7  0  0  0  0  0  0  0  1  4  0 
 0  0  4  1  5  0  0  0  0  0  0  0  0  0  0  0  0  1  0  0 
 0  0  0  1  5  0  0  0  0  0  0  0  0  0  0  0  0  1  0  0 
 0  0  0  1  5  0  0  0  0  0  0  0  0  0  0  0  0  1  0  0 
 0  0  0  1  4  5  5  5  6  5  5  5  5  6  5  0  2  1  0  0 
 0  0  0  1  1  1  1  1  1  1  1  1  1  1  1  1  1  1  0  0 
 0  0  5  5  5  5  5  5  5  5  5  5  5  5  5  5  5  0  6  0 
